11111111111111111111111221111111111111111111111111
10000000000000000000000000000000000000000000000001
10000000000000000000000000000000000000000000000001
10000000000000000000000000000000000000000000000001
10000000000000000000000000000000000000000000000001
10000333300000000000003333000000000000000333300001
10000333300000000000003333000000000000000333300001
10000333300000000000003333000000000000000333300001
10000333300000000000003333000000000000000333300001
10000000000000000000000000000000000000000000000001
10000000000000000000000000000000000000000000000001
10000000000000400000000000000000004000000000000001
10000000000000000000000000000000000000000000000001
10000000000000000000000000000000000000000000000001
10000000000000000000000000000000000000000000000001
10000000000000000000000000000000000000000000000001
10000333300000000000003333000000000000000333300001
10000333300000000000003333000000000000000333300001
10000333300000000000003333000000000000000333300001
10000333300000000000003333000000000000000333300001
10000000000000000000000000000000000000000000000001
10000000000000000000000000000000000000000000000001
10000000000000000000000000000000000000000000000001
10000000000000000000000000000000000000000000000001
20000000000000000000000000000000000000000000000002
20000000000000000000000400000000000000000000000002
10000000000000000000000000000000000000000000000001
10000000000000000000000000000000000000000000000001
10000000000000000000000000000000000000000000000001
10000000000000000000000000000000000000000000000001
10000333300000000000003333000000000000000333300001
10000333300000000000003333000000000000000333300001
10000333300000000000003333000000000000000333300001
10000333300000000000003333000000000000000333300001
10000000000000000000000000000000000000000000000001
10000000000000000000000000000000000000000000000001
10000000000000000000000000000000000000000000000001
10000000000000400000000000000000004000000000000001
10000000000000000000000000000000000000000000000001
10000000000000000000000000000000000000000000000001
10000000000000000000000000000000000000000000000001
10000333300000000000003333000000000000000333300001
10000333300000000000003333000000000000000333300001
10000333300000000000003333000000000000000333300001
10000333300000000000003333000000000000000333300001
10000000000000000000000000000000000000000000000001
10000000000000000000000000000000000000000000000001
10000000000000000000000000000000000000000000000001
10000000000000000000000000000000000000000000000001
11111111111111111111111221111111111111111111111111
